222222222222222222222222222222222222222222222222222222222222222222222222222222222222222222222222222222222222222222222222222222222222222222222222222222
222222222222222222222222222222222222222222222222222222222222222222222222222222222222222222222222222222222222222222222222222222222222222222222222222222
220000000000000000000000000000000000000000000000000000000000000000000000000000000000000000000000000000000000000000000000000000000000000000000000000022
220000000000000000000000000000000000000000000000000000000000000000000000000000000000000000000000000000000000000000000000000000000000000000000000000022
220000000000000000000000000000000000000000000000000000000000000000000000000000000000000000000000000000000000000000000000000000000000000000000000000022
220000000000000000000000000000000000000000000000000000000000000000000000000000000000000000000000000000000000000000000000000000000000000000000000000022
220000000000000000000000000000000000000000000000000000000000000000000000000000000000000000000000000000000000000000000000000000000000000000000000000022
220000000000000000000000000000000000000000000000000000000000000000000000000000000000000000000000000000000000000000000000000000000000000000000000000022
220000000000000000000000000000000000000000000000000000000000000000000000000000000000000000000000000000000000000000000000000000000000000000000000000022
220000000000000000000000000000000000000000000000000000000000000000000000000000000000000000000000000000000000000000000000000000000000000000000000000022
220000000000000000000000000000000000000000000000000000000000000000000000000000000000000000000000000000000000000000000000000000000000000000000000000022
220000000000000000000000000000000000000000000000000000000000000000000000000000000000000000000000000000000000000000000000000000000000000000000000000022
220000000000000000000000000000000000000000000000000000000000000000000000000000000000000000000000000000000000000000000000000000000000000000000000000022
220000000000000000000000000000000000000000000000000000000000000000000000000000000000000000000000000000000000000000000000000000000000000000000000000022
220000000000000000000000000000000000000000000000000000000000000000000000000000000000000000000000000000000000000000000000000000000000000000000000000022
220000000000000000000000000000000000000000000000000000000000000000000000000000000000000000000000000000000000000000000000000000000000000000000000000022
220000000000000000000000000000000000000000000000000000000000000000000000000000000000000000000000000000000000000000000000000000000000000000000000000022
220000000000000000000000000000000000000000000000000000000000000000000000000000000000000000000000000000000000000000000000000000000000000000000000000022
220000000000000000000000000000000000000000000000000000000000000000000000000000000000000000000000000000000000000000000000000000000000000000000000000022
220000000000000000000000000000000000000000000000000000000000000000000000000000000000000000000000000000000000000000000000000000000000000000000000000022
220000000000000000000000000000000000000000000000000000000000000000000000000000000000000000000000000000000000000000000000000000000000000000000000000022
220000000000000000000000000000000000000000000000000000000000000000000000000000000000000000000000000000000000000000000000000000000000000000000000000022
220000000000000000000000000000000000000000000000000000000000000000000000000000000000000000000000000000000000000000000000000000000000000000000000000022
220000000000000000000000000000000000000000000000000000000000000000000000000000000000000000000000000000000000000000000000000000000000000000000000000022
220000000000000000000000000000000000000000000000000000000000000000000000000000000000000000000000000000000000000000000000000000000000000000000000000022
220000000000000000000000000000000000000000000000000000000000000000000000000000000000000000000000000000000000000000000000000000000000000000000000000022
220000000000000000000000000000000000000000000000000000000000000000000000000000000000000000000000000000000000000000000000000000000000000000000000000022
220000000000000000000000000000000000000000000000000000000000000000000000000000000000000000000000000000000000000000000000000000000000000000000000000022
220000000000000000000000000000000000000000000000000000000000000000000000000000000000000000000000000000000000000000000000000000000000000000000000000022
220000000000000000000000000000000000000000000000000000000000000000000000000000000000000000000000000000000000000000000000000000000000000000000000000022
220000000000000000000000000000000000000000000000000000000000000000000000000000000000000000000000000000000000000000000000000000000000000000000000000022
220000000000000000000000000000000000000000000000000000000000000000000000000000000000000000000000000000000000000000000000000000000000000000000000000022
220000000000000000000000000000000000000000000000000000000000000000000000000000000000000000000000000000000000000000000000000000000000000000000000000022
220000000000000000000000000000000000000000000000000000000000000000000000000000000000000000000000000000000000000000000000000000000000000000000000000022
220000000000000000000000000000000000000000000000000000000000000000000000000000000000000000000000000000000000000000000000000000000000000000000000000022
220000000000000000000000000000000000000000000000000000000000000000000000000000000000000000000000000000000000000000000000000000000000000000000000000022
220000000000000000000000000000000000000000000000000000000000000022000000000000000000000000000000000000000000000000000000000000000000000000000000000022
220000000000000000000000000000000000000000000000000000000000000022000000000000000000000000000000000000000000000000000000000000000000000000000000000022
220000000000000000000000000000000000000000000000000000000000000022000000000000000000000000000000000000000000000000000000000000000000000000000000000022
220000000000000000000000000000000000000000000000000000000000000022000000000000000000000000000000000000000000000000000000000000000000000000000000000022
220000000000000000000000000000000000000000000000000000000000000022000000000000000000000000000000000000000000000000000000000000000000000000000000000022
220000000000000000000000000000000000000000000000000000000000000022000000000000000000000000000000000000000000000000000000000000000000000000000000000022
220000000000000000000000000000000000000000000000000000000000000022000000000000000000000000000000000000000000000000000000000000000000000000000000000022
220000000000000000000000000000000000000000000000000000000000000022000000000000000000000000000000000000000000000000000000000000000000000000000000000022
220000000000000000000000000000000000000000000000000000000000000022000000000000000000000000000000000000000000000000000000000000000000000000000000000022
220000000000000000000000000000000000000000000000000000000000000022000000000000000000000000000000000000000000000000000000000000000000000000000000000022
220000000000000000000000000000000000000000000000000000000000000022000000000000000000000000000000000000000000000000000000000000000000000000000000000022
220000000000000000000000000000000000000000000000000000000000000022000000000000000000000000000000000000000000000000000000000000000000000000000000000022
220000000000000000000000000000000000000000000000000000000000000022000000000000000000000000000000000000000000000000000000000000000000000000000000000022
220000000000000000000000000000000000000000000000000000000000000022000000000000000000000000000000000000000000000000000000000000000000000000000000000022
220000000000000000000000000000000000000000000000000000000000000022000000000000000000000000000000000000000000000000000000000000000000000000000000000022
220000000000000000000000000000000000000000000000000000000000000022000000000000000000000000000000000000000000000000000000000000000000000000000000000022
220000000000000000000000000000000000000000000000000000000000000022000000000000000000000000000000000000000000000000000000000000000000000000000000000022
220000000000000000000000000000000000000000000000000000000000000022000000000000000000000000000000000000000000000000000000000000000000000000000000000022
220000000000000000000000000000000000000000000000000000000000000022000000000000000000000000000000000000000000000000000000000000000000000000000000000022
220000000000000000000000000000000000000000000000000000000000000022000000000000000000000000000000000000000000000000000000000000000000000000000000000022
220000000000000000000000000000000000000000000000000000000000000022000000000000000000000000000000000000000000000000000000000000000000000000000000000022
220000000000000000000000000000000000000000000000000000000000000022000000000000000000000000000000000000000000000000000000000000000000000000000000000022
220000000000000000000000000000000000000000000000000000000000000022000000000000000000000000000000000000000000000000000000000000000000000000000000000022
220000000000000000000000000000000000000000000000000000000000000022000000000000000000000000000000000000000000000000000000000000000000000000000000000022
220000000000000000000000000000000000000000000000000000000000000022000000000000000000000000000000000000000000000000000000000000000000000000000000000022
220000000000000000000000000000000000000000000000000000000000000022000000000000000000000000000000000000000000000000000000000000000000000000000000000022
220000000000000000000000000000000000000000000000000000000000000022000000000000000000000000000000000000000000000000000000000000000000000000000000000022
220000000000000000000000000000000000000000000000000000000000000022000000000000000000000000000000000000000000000000000000000000000000000000000000000022
220000000000000000000000000000000000000000000000000000000000000022000000000000000000000000000000000000000000000000000000000000000000000000000000000022
220000000000000000000000000000000000000000000000000000000000000022000000000000000000000000000000000000000000000000000000000000000000000000000000000022
220000000000000000000000000000000000000000000000000000000000000022000000000000000000000000000000000000000000000000000000000000000000000000000000000022
220000000000000000000000000000000000000000000000000000000000000022000000000000000000000000000000000000000000000000000000000000000000000000000000000022
220000000000000000000000000000000000000000000000000000000000000022000000000000000000000000000000000000000000000000000000000000000000000000000000000022
220000000000000000000000002222222222222222222222222222222222222222000000000000000000000000000000000000000000000000000000000000000000000000000000000022
220000000000000000000000002222222222222222222222222222222222222222000000000000000000000000000000000000000000000000000000000000000000000000000000000022
220000000000000000000000002200003300000000000000000000000000000033000000000000000000000000000000000000000000000000000000000000000000000000000000000022
220000000000000000000000002200003300000000000000000000000000000033000000000000000000000000000000000000000000000000000000000000000000000000000000000022
220000000000000000000000002200003300000000000000000000000000000033000000000000000000000000000000000000000000000000000000000000000000000000000000000022
220000000000000000000000002200003300000000000000000000000000000033000000000000000000000000000000000000000000000000000000000000000000000000000000000022
220000000000000000000000002200003300000000000000000000000000000033000000000000000000000000000000000000000000000000000000000000000000000000000000000022
220000000000000000000000002200002222222222222222222222222222222222000000000000000000000000000000000000000000000000000000000000000000000000000000000022
220000000000000000000000002200002222222222222222222222222222222222000000000000000000000000000000000000000000000000000000000000000000000000000000000022
220000000000000000000000002200002200000000000000000000000000000022000000000000000000000000000000000000000000000000000000000000000000000000000000000022
220000000000000000000000002200002200000000000000000000000000000022000000000000000000000000000000000000000000000000000000000000000000000000000000000022
220000000000000000000000002200002200000000000000000000000000000022000000000000000000000000000000000000000000000000000000000000000000000000000000000022
220000000000000000000000002200002200000000000000000000000000000022000000000000000000000000000000000000000000000000000000000000000000000000000000000022
220000000000000000000000002200002200000000000000000000000000000022000000000000000000000000000000000000000000000000000000000000000000000000000000000022
220000000000000000000000002200002200000000000000000000000000000022000000000000000000000000000000000000000000000000000000000000000000000000000000000022
220000000000000000000000002200002200000000000000000000000000000022000000000000000000000000000000000000000000000000000000000000000000000000000000000022
220000000000000000000000002200002200000000000000000000000000000022000000000000000000000000000000000000000000000000000000000000000000000000000000000022
220000000000000000000000002200002200000000000000000000000000000022000000000000000000000000000000000000000000000000000000000000000000000000000000000022
220000000000000000000000002200002200000000000000000000000000000022000000000000000000000000000000000000000000000000000000000000000000000000000000000022
220000000000000000000000002200002200000000000000000000000000000022000000000000000000000000000000000000000000000000000000000000000000000000000000000022
220000000000000000000000002200002200000000000000000000000000000022000000000000000000000000000000000000000000000000000000000000000000000000000000000022
220000000000000000000000002200002200000000000000000000000000000022000000000000000000000000000000000000000000000000000000000000000000000000000000000022
220000000000000000000000002200002200000000000000000000000000000022000000000000000000000000000000000000000000000000000000000000000000000000000000000022
220000000000000000000000002200002200000000000000000000000000000022000000000000000000000000000000000000000000000000000000000000000000000000000000000022
222222222222222222222222222233332200000000000000000000000000000022000000000000000000000000000000000000000000000000000000000000000000000000000000000022
222222222222222222222222222233332200000000000000000000000000000022000000000000000000000000000000000000000000000000000000000000000000000000000000000022
220000000000000000000000003300002200000000000000000000000000000022000000000000000000000000000000000000000000000000000000000000000000000000000000000022
220000000000000000000000003300002200000000000000000000000000000022000000000000000000000000000000000000000000000000000000000000000000000000000000000022
220000000000000000000000003300002200000000000000000000000000000022000000000000000000000000000000000000000000000000000000000000000000000000000000000022
220000000000000000000000003300002200000000000000000000000000000022000000000000000000000000000000000000000000000000000000000000000000000000000000000022
220000000000000000000000222222222200000000000000000000000000000022000000000000000000000000000000000000000000000000000000000000000000000000000000000022
220000000000000000000000222222222200000000000000000000000000000022000000000000000000000000000000000000000000000000000000000000000000000000000000000022
220000000000000000000000220000000000000000000000000000000000000022000000000000000000000000000000000000000000000000000000000000000000000000000000000022
220000000000000000000000220000000000000000000000000000000000000022000000000000000000000000000000000000000000000000000000000000000000000000000000000022
220000000000000000000000220000000000000000000000000000000000000033000000000000000000000000000000000000000000000000000000000000000000000000000000000022
220000000000000000000000220000000000000000000000000000000000000033000000000000000000000000000000000000000000000000000000000000000000000000000000000022
220000000000000000000000220000000000000000000000000000000000000033000000000000000000000000000000000000000000000000000000000000000000000000000000000022
220000000000000000000000220000000000000000000000000000000000000033000000000000000000000000000000000000000000000000000000000000000000000000000000000022
220000000000000000000000220000000000000000000000000000000000000022000000000000000000000000000000000000000000000000000000000000000000000000000000000022
220000000000000000000000220000000000000000000000000000000000000022000000000000000000000000000000000000000000000000000000000000000000000000000000000022
220000000000000000000000220000000000000000000000000000000000000022000000000000000000000000000000000000000000000000000000000000000000000000000000000022
220000000000000000000000220000000000000000000000000000000000000022000000000000000000000000000000000000000000000000000000000000000000000000000000000022
220000000000000000000000220000000000000000000000000000000000000022000000000000000000000000000000000000000000000000000000000000000000000000000000000022
220000000000000000000000220000000000000000000000000000000000000022000000000000000000000000000000000000000000000000000000000000000000000000000000000022
222222222233333333332200220000000000000000000000000000000000000022000000000000000000000000000000000000000000000000000000000000000000000000000000000022
222222222233333333332200222222222222222222222222222222222222222222000000000000000000000000000000000000000000000000000000000000000000000000000000000022
220000002200000000002200222222222222222222222222222222222222222222000000000000000000000000000000000000000000000000000000000000000000000000000000000022
220000002200000000002200220000000000000000000000000000000000000000000000000000000000000000000000000000000000000000000000000000000000000000000000000022
220000002222222222002200220000000000000000000000000000000000000000000000000000000000000000000000000000000000000000000000000000000000000000000000000022
220000002222222222002200220000000000000000000000000000000000000000000000000000000000000000000000000000000000000000000000000000000000000000000000000022
220000003300000022002200220000000000000000000000000000000000000000000000000000000000000000000000000000000000000000000000000000000000000000000000000022
220000003300000022002200220000000000000000000000000000000000000000000000000000000000000000000000000000000000000000000000000000000000000000000000000022
220000003300000022002200220000000000000000000000000000000000000000000000000000000000000000000000000000000000000000000000000000000000000000000000000022
220000003300000022002200220000000000000000000000000000000000000000000000000000000000000000000000000000000000000000000000000000000000000000000000000022
220000002222222222002200220000000000000000000000000000000000000000000000000000000000000000000000000000000000000000000000000000000000000000000000000022
220000002222222222002200220000000000000000000000000000000000000000000000000000000000000000000000000000000000000000000000000000000000000000000000000022
220000000000000000002200220000000000000000000000000000000000000000000000000000000000000000000000000000000000000000000000000000000000000000000000000022
220000000000000000002200220000000000000000000000000000000000000000000000000000000000000000000000000000000000000000000000000000000000000000000000000022
222222222222222222222200220000000000000000000000000000000000000000000000000000000000000000000000000000000000000000000000000000000000000000000000000022
222222222222222222222200220000000000000000000000000000000000000000000000000000000000000000000000000000000000000000000000000000000000000000000000000022
220000000000000000000000000000000000000000000000000000000000000000000000000000000000000000000000000000000000000000000000000000000000000000000000000022
220000000000000000000000000000000000000000000000000000000000000000000000000000000000000000000000000000000000000000000000000000000000000000000000000022
220000000000000000000000000000000000000000000000000000000000000000000000000000000000000000000000000000000000000000000000000000000000000000000000000022
220000000000000000000000000000000000000000000000000000000000000000000000000000000000000000000000000000000000000000000000000000000000000000000000000022
220000000000000000000000000000000000000000000000000000000000000000000000000000000000000000000000000000000000000000000000000000000000000000000000000022
220000000000000000000000000000000000000000000000000000000000000000000000000000000000000000000000000000000000000000000000000000000000000000000000000022
220000000000000000000000000000000000000000000000000000000000000000000000000000000000000000000000000000000000000000000000000000000000000000000000000022
220000000000000000000000000000000000000000000000000000000000000000000000000000000000000000000000000000000000000000000000000000000000000000000000000022
220000000000000000000000000000000000000000000000000000000000000000000000000000000000000000000000000000000000000000000000000000000000000000000000000022
220000000000000000000000000000000000000000000000000000000000000000000000000000000000000000000000000000000000000000000000000000000000000000000000000022
220000000000000000000000000000000000000000000000000000000000000000000000000000000000000000000000000000000000000000000000000000000000000000000000000022
220000000000000000000000000000000000000000000000000000000000000000000000000000000000000000000000000000000000000000000000000000000000000000000000000022
220000000000000000000000000000000000000000000000000000000000000000000000000000000000000000000000000000000000000000000000000000000000000000000000000022
220000000000000000000000000000000000000000000000000000000000000000000000000000000000000000000000000000000000000000000000000000000000000000000000000022
220000000000000000000000000000000000000000000000000000000000000000000000000000000000000000000000000000000000000000000000000000000000000000000000000022
220000000000000000000000000000000000000000000000000000000000000000000000000000000000000000000000000000000000000000000000000000000000000000000000000022
220000000000000000000000000000000000000000000000000000000000000000000000000000000000000000000000000000000000000000000000000000000000000000000000000022
220000000000000000000000000000000000000000000000000000000000000000000000000000000000000000000000000000000000000000000000000000000000000000000000000022
220000000000000000000000000000000000000000000000000000000000000000000000000000000000000000000000000000000000000000000000000000000000000000000000000022
222222222222222222222222222222222222222222222222222222222222222222222222222222222222222222222222222222222222222222222222222222222222222222222222222222
222222222222222222222222222222222222222222222222222222222222222222222222222222222222222222222222222222222222222222222222222222222222222222222222222222
